24, 13
BBBBBBBBBBBBBBBBBBBBBBBB
BPPPPPPPPPPPPPPPPPPPPPPB
BPGGPGGGGGGGPGGGPGGHGGPB
BPGGPHHHHHHHPGGGPGGHGGPB
BPHHPGGGGGGGPGGGPGGHGGPB
BPGGPPPPPPPPPPPPPGGHGGPB
BPGGPGGGHGGGPGGGPGGHGGPB
BPPPPPPPPPPPPHHHPPPPPPPB
BPGGPGGGGGGGPGGGGGGPGGPB
BPPPPPPPPPPPPPPPPPPPHHPB
BPGGGGPGGHGGGGGGGGGPGGGB
BPPPPPPPPPPPPPPPPPPPPPPB
BBBBBBBBBBBBBBBBBBBBBBBB
M 19 6
C 2 7
C 5 3
C 12 6
1 4 1
2 12 8
3 4 8
4 2 1
5 6 11