30, 18
BBBBBBBBBBBBBBBBBBBBBBBBBBBBBB
BPPPPPPPPPPPPPPPPPPPPPPPPPPPPB
BPHHHHHPPHHHHHPHHHHHHHHHHHHHPB
BPHBBBHPPHBBBHPHBBBBHPHBBBBHPB
BPTTTBHPPTTTBHPHBBBTTPTTBBBHPB
BPHBTBHPPHBTBHPHBBTTBPBTTBBHPB
BPHBTTTPPHBTTTPHBTTBBPBBTTBHPB
BPHBBBHPPHBBBHPTTTBBBPBBBTTHPB
BPHHHHHPPHHHHHPHHHHHHPHHHHTHPB
BPPPPPPPPPPPPPPPPPPPPPPPPPPPPB
BPHHHHHTHHHHHHPHHHHHHHHTHHHHPB
BPHBBBBTBBBBBHPHHHHHHHHTHHHHPB
BPHBBBBTTTTTTTPPPPPPPPPPPPPHPB
BPTTTTTTTBBBBHPPPPPPPPPPPPPHPB
BPHBBBBBTBBBBHPHHHHHHTHHHHHHPB
BPHHHHHHTHHHHHPHHHHHHTHHHHHHPB
BPPPPPPPPPPPPPPPPPPPPPPPPPPPPB
BBBBBBBBBBBBBBBBBBBBBBBBBBBBBB
M 7 13
C 1 1
C 21 5
C 20 13
1 23 13
2 8 8
3 21 7
4 1 9
5 1 16