24, 15
BBBBBBBBBBBBBBBBBBBBBBBB
BPPPPPPPPPPPPGPPPPPPPHPB
BPGGHGGPGGGGGGHGGGGPGGPB
BPHPPPPPPPPPPPPPPPGPPGPB
BPGGGGGGHGGGGGPPPGGPPGPB
BPHPGPPGPGPPPPPPPPPPPGPB
BPGPGGPPPGPGGGPGGGGPPGPB
BPGPGPPGPGPPGPPPPPHPPPPB
BPPPPPGGPGPPGGHGGPGPPPGB
BPGPGPPGPGPPPPHGPPPPPPGB
BPGPGGPGPGGGPGGGPGHGGGGB
BPGPGPPGPPPPPPPGPPPPPPPB
BPGPHPGGPGPGPPPGPGGGGPPB
BPPPGPPHPHPGPPPGPPPPGPPB
BBBBBBBBBBBBBBBBBBBBBBBB
M 4 1
C 4 3
C 1 3
C 12 6
1 1 2
2 8 3
3 1 13
4 3 3
5 22 5